NO ./ressources/doom_north.xpm
SO ./ressources/doom_south.xpm
WE ./ressources/doom_west.xpm
EA ./ressources/doom_east.xpm

F 117,89,82
C 46,192,240

	1111111111111111111111111111111111111111111111111111111111111111111111111111111111111111111111111111111111111111111111111111
	10000000000000000000000000000000000000000000000000000000000000000000000000000000000000000000000000000000000000000000000000001
	1000000001111111111100011111111100100000000001111111111111111111111111111111111111111111111111111111111111111111111111111111
	1000000001000000000000000000000000000000000001
	10000000010000000000000011111100001000000000011111
	10000000010000100000001111000000000000100000000001
	10000000000010111100000011111100000000000000011111
	1000000000000000000000000000000000000000000001
	1000E01010000000000000000000000000100000000001
	1000000000000000011111100000000000100000000001
	1000000100000000000000000000000000100000000001
	100000100000111111011111111110111100000000001
	1000000100000000000000000000000000000000000001
	1000000000000000000000000000000000000000000001
	1111111111111111111111111111111111111111111111
