446546

545
4
4
htrttrhr

     1
 11110111
10000001
10000111
100000
111111
