F 255,253,0

WE LOL

NO MDR

EA 4784

C 255,225,2255

SO 8

1111111
00
11
1144
00
00000





