F 0,0,0
WE L
NO M
EA 4
C 0,0,0
SO 8


10000000000000000000
1000
110
11
0
1111
