F 11,89,82
EA ./ressources/cat_east.xpm
NO ./ressources/cat_north.xpm
SO ./ressources/cat_south.xpm
C 23,34,32
WE ./ressources/cat_west.xpm



1111111
1000E01
1111111
