F 11,89,82
EA                ./ressources/east.xpm
NO ./ressources/north.xpm


SO ./ressources/south.xpm
C 46,192,240
WE ./ressources/west.xpm


1111
10W1
1111
