NO ./ressources/north.xpm
SO ./ressources/south.xpm
WE ./ressources/west.xpm
EA ./ressources/east.xpm

F 117,89,82
C 146,92,240

111111111111111111111111111111111111111111111111111111111111111111111111111111111111111111111111111111111111111111111111111
1N0000000000000000000000000000000000000000000000000000000000000000000000000000000000000000000000000000000000000000000000001
10000000011111111111000111111111001000000000011111111111111111111111111111111111111111111111111111111111111111111111111111111
1000000001000000000000000000000000000000000001
1000000001000000000000001111110000000000000011111
10000000010001100000001111000000000000100000000001
10000000000010111100000011111100000000000000011111
1000000000000111100000000001100000000000000001
100000101000101000100000010100000001000000000011
10000000000001111011111100011000000100000000001
1000000100000000000000000000000000100000000001
1000001000000111111011111111110111100000000001
1000000100000000000000000000000000000000000001
1000000000000000000000000000000000000000000001
1111111111111111111111111111111111111111111111
