NO ./ressources/north.xpm
SO ./ressources/south.xpm
WE ./ressources/west.xpm
EA ./ressources/east.xpm

F 117,89,82
C 46,192,240

          1111111111111111111111111
          1000000000110000000000001
          1011000001110000000000001
          1001000000000000 000000001
          11111111101100000111001111111
11111111111000001110111111011111
11110111111111011100000010001
11110111111111011101010010001
11000000110101011100000010001
10000000000000001100000000001
10000000000000001101010010001
11000001110101011111011110N0111
11110111 1110101 101111010001
11111111 1111111 111111111111
