NO ./ressources/north.xpm
SO ./ressources/south.xpm
WE ./ressources/west.xpm
EA ./ressources/east.xpm

F 117,89,82
C 146,92,240

          1111111111111111111111111
          1000010000110000000000001
          1011000001110000000000001
          1001000000000000000000001
          1111111110110000011100111
11111111111000000000111111011111
11110111111111011100000010001
11110111111111011101010010001    111
11000000110101011100000010001    101
10000000000000S001100000000001    111
10000000000000001101010010001
11000001110101011111011110000111
11110111 1110101 101111010001
11111111 1111111 111111111111
1        10001   1
1111111111111111
1000000000000001
1111111111111111
