NO ./ressources/north.xpm
SO ./ressources/south.xpm
WE ./ressources/west.xpm
EA ./ressources/east.xpm

F 117,89,82
C 146,92,240

11111111111111111
  10000000111
  11110000E001
   1111111111
